//MAP CONVERTED BY dmm2tgm.py THIS HEADER COMMENT PREVENTS RECONVERSION, DO NOT REMOVE
"aE" = (
/turf/closed/wall/mineral/titanium/shuttle_wall/kodiak/alliance{
	icon_state = "0,3"
	},
/area/shuttle/modular_shuttle/kodiak/ruin/miner)
"aM" = (
/obj/effect/turf_decal/siding/blue{
	dir = 9
	},
/obj/machinery/computer/shuttle/modular_shuttle/ruin/kodiak/miner,
/turf/open/floor/iron/dark/smooth_large,
/area/shuttle/modular_shuttle/kodiak/ruin/miner)
"bn" = (
/obj/effect/turf_decal/siding/blue{
	dir = 5
	},
/obj/structure/fans/tiny,
/obj/machinery/door/airlock/titanium/glass,
/obj/effect/mapping_helpers/airlock/access/all/supply/mining,
/turf/open/floor/iron/dark/textured_large,
/area/shuttle/modular_shuttle/kodiak/ruin/miner)
"bN" = (
/turf/closed/wall/mineral/titanium/shuttle_wall/kodiak/alliance{
	icon_state = "0,9"
	},
/area/shuttle/modular_shuttle/kodiak/ruin/miner)
"fc" = (
/turf/closed/wall/mineral/titanium/shuttle_wall/kodiak/alliance{
	icon_state = "3,1"
	},
/area/shuttle/modular_shuttle/kodiak/ruin/miner)
"fp" = (
/obj/effect/turf_decal/siding/blue{
	dir = 1
	},
/obj/machinery/computer/camera_advanced/shuttle_docker/ruin/kodiak/miner,
/turf/open/floor/iron/dark/smooth_large,
/area/shuttle/modular_shuttle/kodiak/ruin/miner)
"jy" = (
/turf/closed/wall/mineral/titanium/shuttle_wall/kodiak/alliance{
	icon_state = "2,1"
	},
/area/shuttle/modular_shuttle/kodiak/ruin/miner)
"jE" = (
/turf/closed/wall/mineral/titanium/shuttle_wall/kodiak/alliance{
	icon_state = "0,7"
	},
/area/shuttle/modular_shuttle/kodiak/ruin/miner)
"jG" = (
/turf/closed/wall/mineral/titanium/shuttle_wall/kodiak/alliance{
	icon_state = "4,10"
	},
/area/shuttle/modular_shuttle/kodiak/ruin/miner)
"kd" = (
/obj/structure/chair/comfy/shuttle/tactical{
	dir = 1
	},
/turf/open/floor/iron/dark/smooth_large,
/area/shuttle/modular_shuttle/kodiak/ruin/miner)
"lL" = (
/obj/effect/turf_decal/siding/blue{
	dir = 5
	},
/turf/open/floor/iron/dark/smooth_large,
/area/shuttle/modular_shuttle/kodiak/ruin/miner)
"mv" = (
/turf/closed/wall/mineral/titanium/shuttle_wall/kodiak/alliance{
	icon_state = "4,8"
	},
/area/shuttle/modular_shuttle/kodiak/ruin/miner)
"mR" = (
/turf/closed/wall/mineral/titanium/shuttle_wall/kodiak/alliance{
	icon_state = "0,4"
	},
/area/shuttle/modular_shuttle/kodiak/ruin/miner)
"mU" = (
/turf/closed/wall/mineral/titanium/shuttle_wall/kodiak/alliance{
	icon_state = "4,3"
	},
/area/shuttle/modular_shuttle/kodiak/ruin/miner)
"nk" = (
/obj/docking_port/mobile{
	dir = 8;
	height = 5;
	id = "kodiak_miner";
	name = "Alliance UT-47 Miner Kodiak";
	width = 11;
	dwidth = 5;
	preferred_direction = 4
	},
/obj/effect/turf_decal/siding/blue{
	dir = 6
	},
/obj/structure/fans/tiny,
/obj/machinery/door/airlock/titanium/glass,
/obj/effect/mapping_helpers/airlock/access/all/supply/mining,
/turf/open/floor/iron/dark/textured_large,
/area/shuttle/modular_shuttle/kodiak/ruin/miner)
"nq" = (
/obj/structure/closet/crate,
/turf/open/floor/iron/dark/smooth_large,
/area/shuttle/modular_shuttle/kodiak/ruin/miner)
"qb" = (
/turf/closed/wall/mineral/titanium/shuttle_wall/kodiak/alliance{
	icon_state = "2,10"
	},
/area/shuttle/modular_shuttle/kodiak/ruin/miner)
"rP" = (
/turf/closed/wall/mineral/titanium/shuttle_wall/kodiak/alliance{
	icon_state = "4,0"
	},
/area/shuttle/modular_shuttle/kodiak/ruin/miner)
"sy" = (
/turf/closed/wall/mineral/titanium/shuttle_wall/kodiak/alliance{
	icon_state = "3,10"
	},
/area/shuttle/modular_shuttle/kodiak/ruin/miner)
"sY" = (
/turf/closed/wall/mineral/titanium/shuttle_wall/kodiak/alliance{
	icon_state = "1,1"
	},
/area/shuttle/modular_shuttle/kodiak/ruin/miner)
"tH" = (
/turf/closed/wall/mineral/titanium/shuttle_wall/kodiak/alliance{
	icon_state = "4,7"
	},
/area/shuttle/modular_shuttle/kodiak/ruin/miner)
"uc" = (
/turf/closed/wall/mineral/titanium/shuttle_wall/kodiak/alliance{
	icon_state = "3,0"
	},
/area/shuttle/modular_shuttle/kodiak/ruin/miner)
"vk" = (
/turf/closed/wall/mineral/titanium/shuttle_wall/kodiak/alliance{
	icon_state = "0,8"
	},
/area/shuttle/modular_shuttle/kodiak/ruin/miner)
"vv" = (
/turf/closed/wall/mineral/titanium/shuttle_wall/kodiak/alliance{
	icon_state = "3,2"
	},
/area/shuttle/modular_shuttle/kodiak/ruin/miner)
"vZ" = (
/obj/structure/chair/comfy/shuttle/tactical{
	dir = 1
	},
/obj/machinery/light/directional/west,
/obj/effect/turf_decal/siding/blue{
	dir = 8
	},
/turf/open/floor/iron/dark/smooth_large,
/area/shuttle/modular_shuttle/kodiak/ruin/miner)
"wF" = (
/obj/effect/turf_decal/siding/blue{
	dir = 10
	},
/obj/structure/fans/tiny,
/obj/machinery/door/airlock/titanium/glass,
/obj/effect/mapping_helpers/airlock/access/all/supply/mining,
/turf/open/floor/iron/dark/textured_large,
/area/shuttle/modular_shuttle/kodiak/ruin/miner)
"xm" = (
/obj/effect/turf_decal/siding/blue/corner{
	dir = 8
	},
/obj/effect/turf_decal/stripes/line{
	dir = 8
	},
/turf/open/floor/iron/dark/textured_large,
/area/shuttle/modular_shuttle/kodiak/ruin/miner)
"xJ" = (
/obj/structure/chair/comfy/shuttle/tactical{
	dir = 8
	},
/obj/effect/turf_decal/siding/blue{
	dir = 6
	},
/turf/open/floor/iron/dark/smooth_large,
/area/shuttle/modular_shuttle/kodiak/ruin/miner)
"yj" = (
/turf/closed/wall/mineral/titanium/shuttle_wall/kodiak/alliance{
	icon_state = "4,2"
	},
/area/shuttle/modular_shuttle/kodiak/ruin/miner)
"Aj" = (
/obj/effect/turf_decal/siding/blue{
	dir = 9
	},
/obj/structure/fans/tiny,
/obj/machinery/door/airlock/titanium/glass,
/obj/effect/mapping_helpers/airlock/access/all/supply/mining,
/turf/open/floor/iron/dark/textured_large,
/area/shuttle/modular_shuttle/kodiak/ruin/miner)
"Ax" = (
/obj/structure/chair/comfy/shuttle/tactical{
	dir = 4
	},
/obj/effect/turf_decal/siding/blue{
	dir = 10
	},
/turf/open/floor/iron/dark/smooth_large,
/area/shuttle/modular_shuttle/kodiak/ruin/miner)
"AE" = (
/turf/closed/wall/mineral/titanium/shuttle_wall/kodiak/alliance{
	icon_state = "0,2"
	},
/area/shuttle/modular_shuttle/kodiak/ruin/miner)
"Cg" = (
/turf/closed/wall/mineral/titanium/shuttle_wall/kodiak/alliance{
	icon_state = "0,10"
	},
/area/shuttle/modular_shuttle/kodiak/ruin/miner)
"CS" = (
/turf/closed/wall/mineral/titanium/shuttle_wall/kodiak/alliance{
	icon_state = "1,10"
	},
/area/shuttle/modular_shuttle/kodiak/ruin/miner)
"De" = (
/turf/closed/wall/mineral/titanium/shuttle_wall/kodiak/alliance{
	icon_state = "1,0"
	},
/area/shuttle/modular_shuttle/kodiak/ruin/miner)
"DQ" = (
/turf/open/floor/iron/dark/textured_large,
/area/shuttle/modular_shuttle/kodiak/ruin/miner)
"Gy" = (
/obj/structure/tank_dispenser/oxygen{
	pixel_x = -1;
	pixel_y = 2
	},
/obj/effect/turf_decal/stripes/corner{
	dir = 8
	},
/obj/effect/turf_decal/siding/blue{
	dir = 8
	},
/turf/open/floor/iron/dark/smooth_large,
/area/shuttle/modular_shuttle/kodiak/ruin/miner)
"GQ" = (
/turf/closed/wall/mineral/titanium/shuttle_wall/kodiak/alliance{
	icon_state = "4,4"
	},
/area/shuttle/modular_shuttle/kodiak/ruin/miner)
"JX" = (
/obj/effect/turf_decal/stripes/corner,
/obj/effect/turf_decal/siding/blue{
	dir = 4
	},
/turf/open/floor/iron/dark/smooth_large,
/area/shuttle/modular_shuttle/kodiak/ruin/miner)
"Kh" = (
/obj/effect/turf_decal/siding/blue/corner{
	dir = 1
	},
/obj/effect/turf_decal/stripes/line{
	dir = 8
	},
/turf/open/floor/iron/dark/textured_large,
/area/shuttle/modular_shuttle/kodiak/ruin/miner)
"Ly" = (
/turf/closed/wall/mineral/titanium/shuttle_wall/kodiak/alliance{
	icon_state = "0,1"
	},
/area/shuttle/modular_shuttle/kodiak/ruin/miner)
"OE" = (
/obj/machinery/light/directional/south,
/obj/effect/turf_decal/siding/blue,
/turf/open/floor/iron/dark/textured_large,
/area/shuttle/modular_shuttle/kodiak/ruin/miner)
"OJ" = (
/obj/structure/chair/comfy/shuttle/tactical{
	dir = 4
	},
/obj/effect/turf_decal/stripes/corner{
	dir = 1
	},
/obj/effect/turf_decal/siding/blue{
	dir = 8
	},
/turf/open/floor/iron/dark/smooth_large,
/area/shuttle/modular_shuttle/kodiak/ruin/miner)
"OW" = (
/turf/closed/wall/mineral/titanium/shuttle_wall/kodiak/alliance{
	icon_state = "4,9"
	},
/area/shuttle/modular_shuttle/kodiak/ruin/miner)
"Pu" = (
/turf/closed/wall/mineral/titanium/shuttle_wall/kodiak/alliance{
	icon_state = "2,2"
	},
/area/shuttle/modular_shuttle/kodiak/ruin/miner)
"PP" = (
/obj/effect/turf_decal/siding/blue/corner{
	dir = 4
	},
/obj/effect/turf_decal/stripes/line{
	dir = 4
	},
/turf/open/floor/iron/dark/textured_large,
/area/shuttle/modular_shuttle/kodiak/ruin/miner)
"SF" = (
/obj/effect/turf_decal/siding/blue/corner,
/obj/effect/turf_decal/stripes/line{
	dir = 4
	},
/turf/open/floor/iron/dark/textured_large,
/area/shuttle/modular_shuttle/kodiak/ruin/miner)
"SR" = (
/turf/open/space/basic,
/area/shuttle/modular_shuttle/kodiak/ruin/miner)
"TH" = (
/turf/closed/wall/mineral/titanium/shuttle_wall/kodiak/alliance{
	icon_state = "0,0"
	},
/area/shuttle/modular_shuttle/kodiak/ruin/miner)
"Vx" = (
/turf/closed/wall/mineral/titanium/shuttle_wall/kodiak/alliance{
	icon_state = "1,2"
	},
/area/shuttle/modular_shuttle/kodiak/ruin/miner)
"Xs" = (
/obj/structure/chair/comfy/shuttle/tactical{
	dir = 8
	},
/obj/effect/turf_decal/stripes/corner{
	dir = 4
	},
/obj/effect/turf_decal/siding/blue{
	dir = 4
	},
/turf/open/floor/iron/dark/smooth_large,
/area/shuttle/modular_shuttle/kodiak/ruin/miner)
"XQ" = (
/obj/machinery/light/directional/east,
/obj/effect/turf_decal/siding/blue{
	dir = 4
	},
/turf/open/floor/iron/dark/smooth_large,
/area/shuttle/modular_shuttle/kodiak/ruin/miner)
"YK" = (
/turf/closed/wall/mineral/titanium/shuttle_wall/kodiak/alliance{
	icon_state = "4,1"
	},
/area/shuttle/modular_shuttle/kodiak/ruin/miner)

(1,1,1) = {"
Cg
bN
vk
jE
Aj
wF
mR
aE
AE
Ly
TH
"}
(2,1,1) = {"
CS
aM
vZ
Gy
Kh
xm
OJ
Ax
Vx
sY
De
"}
(3,1,1) = {"
qb
fp
kd
nq
DQ
DQ
DQ
OE
Pu
jy
SR
"}
(4,1,1) = {"
sy
lL
XQ
JX
PP
SF
Xs
xJ
vv
fc
uc
"}
(5,1,1) = {"
jG
OW
mv
tH
bn
nk
GQ
mU
yj
YK
rP
"}
